2115111111111111111111112
2007000000000000000000002
2000000000800000000000002
2000000333000000400000002
2000000000000000400000002
2000000333000600000000002
2000000000000000000000002
2000000333000000000000002
2000000000000000000000002
2000000333000000000000002
2000000000000000000000002
2000000333000000000000002
2000000000000000000000002
2000000333000000000000002
2222222222222222222222222
