1 5 6 6 6 6 6 6 6 6 6 6 6 6 6 6 6 6 7 1
2 E 1 0 0 1 0 0 X 1 5 6 6 7 1 0 0 1 1 2
3 0 0 X 1 1 0 0 0 2 1 1 2 2 1 0 0 0 1 3
3 0 5 6 7 0 X 0 1 3 1 1 0 0 0 0 0 0 0 3
3 0 @ 0 0 0 H 0 0 4 0 X X 0 0 0 0 0 0 3
3 X 0 X 0 0 X 0 0 0 0 0 0 0 0 0 0 0 0 3
3 X 0 0 X 0 0 0 0 X 0 0 0 0 0 0 0 0 0 3
3 0 0 0 0 0 0 0 X 0 0 0 0 0 0 0 0 0 0 3
3 0 0 0 0 0 0 0 0 0 0 0 0 0 0 0 0 0 0 3
3 0 0 0 0 0 0 0 0 0 0 0 0 0 0 0 0 0 0 3
3 0 0 0 0 0 0 0 0 0 0 0 0 0 0 0 0 0 0 3
3 0 0 0 0 0 0 0 0 0 0 0 0 0 0 0 0 0 0 3
3 0 0 0 0 0 0 0 0 0 0 0 0 0 0 0 0 0 0 3
2 0 0 0 0 0 0 0 0 0 0 0 0 0 0 0 0 0 0 2
1 5 6 6 6 6 6 6 6 6 6 6 6 6 6 6 6 6 7 1