1 2 2 2 2 2 2 2 2 2 2 2 2 2 2 2 2 2 2 2 2 2 2 2 2 2 2 2 2 2 2 2 2 2 1 
1 0 0 0 0 0 0 0 0 0 0 0 0 0 0 0 0 0 0 0 0 0 0 0 0 0 0 0 0 0 0 0 0 0 1 
1 0 0 0 0 1 0 0 0 0 0 0 1 2 0 0 0 0 0 0 0 0 0 0 0 0 0 0 0 0 0 0 0 0 1 
1 0 0 0 1 2 0 0 0 6 2 2 2 0 0 0 0 0 0 0 0 0 0 0 0 0 0 0 0 0 3 0 0 0 1 
1 0 0 0 1 0 0 0 0 6 0 0 0 0 0 0 0 3 0 0 0 0 1 2 3 0 0 0 0 0 0 0 0 0 1 
1 0 0 1 2 0 0 0 0 2 2 0 2 0 0 0 3 0 0 0 2 2 2 0 0 0 0 0 0 0 0 0 0 0 1 
1 0 0 1 0 0 0 0 0 6 0 0 0 0 0 0 0 0 0 0 0 0 0 0 3 0 0 1 0 0 0 0 0 0 1 
1 0 0 2 1 0 0 0 0 0 0 0 0 0 0 0 0 0 2 2 2 0 0 0 0 0 0 2 2 2 1 0 0 0 1 
1 0 0 0 2 2 2 0 0 2 1 0 0 6 0 0 0 3 3 0 0 0 0 2 1 0 0 0 0 0 2 0 0 0 1 
1 0 0 0 0 0 0 0 0 0 2 2 1 6 0 0 1 0 3 3 0 0 0 0 2 0 1 0 0 0 0 3 0 0 1 
1 0 0 0 0 0 1 0 0 0 0 0 1 2 0 2 2 0 0 0 0 1 2 0 0 1 2 0 0 0 0 3 0 0 1 
9 0 0 0 0 0 1 0 6 0 2 2 1 0 0 0 6 6 0 1 2 1 0 0 0 1 0 0 0 0 0 3 0 0 1 
9 0 0 0 0 1 1 6 6 0 0 0 2 1 0 0 0 6 2 1 0 1 2 2 0 1 0 0 0 0 0 0 0 0 1 
1 0 0 1 1 1 1 2 0 0 0 0 0 2 2 2 0 0 0 2 2 1 0 0 0 1 2 2 0 0 0 0 0 0 1 
1 0 0 2 6 0 1 0 0 0 6 0 1 0 0 0 0 0 0 0 0 2 0 0 0 1 0 7 0 1 0 0 3 0 1 
1 0 0 0 0 0 1 0 0 1 0 0 2 2 1 0 0 0 0 6 0 0 0 0 0 2 0 0 0 1 0 0 3 0 1 
1 0 0 0 0 6 1 0 0 1 0 0 0 0 2 2 1 0 0 6 0 0 0 0 0 0 0 0 0 1 0 0 3 0 1 
1 0 0 0 1 1 2 0 0 1 0 6 0 0 0 0 2 0 0 0 0 3 0 0 0 0 0 0 0 1 0 0 3 0 1 
1 0 0 0 2 1 0 0 1 2 0 0 0 0 0 0 0 0 0 0 6 6 0 0 0 1 0 0 0 1 0 0 0 0 1 
1 0 0 0 0 2 0 0 1 0 1 2 2 2 0 0 0 0 0 2 6 6 0 0 0 2 2 0 0 1 0 0 0 0 1 
1 1 1 0 0 0 0 0 1 0 1 0 0 0 0 0 6 0 6 6 6 0 0 0 3 0 0 6 0 2 0 3 0 0 1 
1 1 0 0 0 0 0 0 1 0 2 0 0 6 0 0 0 1 2 0 0 0 0 0 0 0 0 0 0 0 3 3 0 0 1 
1 1 0 0 0 0 0 0 1 0 6 0 0 0 0 0 0 2 0 0 0 0 1 0 0 0 0 0 0 0 3 0 0 0 1 
1 1 0 0 0 6 6 1 1 0 0 0 1 2 0 0 1 0 0 0 0 0 1 0 0 2 2 1 0 0 1 2 0 0 1 
1 2 2 0 0 0 0 1 1 0 0 0 1 0 0 2 2 0 0 3 0 0 1 0 0 0 0 2 2 0 2 0 0 0 1 
1 0 0 0 0 0 0 2 2 0 0 0 2 2 0 0 0 0 0 0 0 0 2 0 0 0 0 0 0 0 0 0 0 0 1 
1 0 0 0 0 6 0 0 0 0 0 0 0 0 3 0 0 0 0 0 0 0 0 2 0 0 0 0 0 0 2 1 0 1 1 
1 0 0 0 0 0 0 0 0 0 0 0 0 6 3 0 0 1 0 0 0 0 0 0 0 0 3 0 0 0 0 2 1 1 1 
1 0 0 0 0 0 0 1 6 0 0 0 0 0 0 0 0 2 2 0 0 0 0 0 0 3 3 0 1 2 0 0 2 0 1 
1 0 0 3 0 0 0 1 2 0 1 0 0 0 3 0 0 0 0 0 0 0 0 0 0 0 0 0 1 0 0 0 0 0 1 
1 0 2 3 0 1 0 1 3 0 1 0 8 0 3 0 0 0 0 0 0 3 0 0 0 0 0 1 2 0 0 2 2 0 1 
1 0 0 2 0 1 0 1 0 0 2 0 0 2 2 2 2 0 0 0 0 0 0 0 0 0 1 2 0 0 0 0 0 0 1 
1 0 0 0 2 2 2 2 0 0 0 2 2 0 0 0 0 0 0 6 6 0 0 0 0 1 2 0 0 0 0 0 0 0 1 
1 0 0 0 0 0 0 0 0 0 0 0 0 0 0 6 6 0 0 0 0 0 0 0 1 1 0 0 0 0 0 0 0 0 1 
2 2 2 2 2 2 2 2 2 2 2 2 2 2 2 2 2 2 2 2 2 2 2 2 2 2 2 2 2 2 2 2 2 2 2