1 2 9 2 2 1 2 2 2 2 1 2 2 2 1
1 0 0 0 0 1 0 0 0 0 1 0 0 0 1
1 0 3 0 0 2 0 0 0 0 1 0 0 0 1
1 0 0 0 0 0 0 0 6 0 1 0 0 0 1
1 0 0 0 0 1 0 0 0 0 1 0 0 0 1
1 0 0 0 0 1 0 5 0 0 1 0 0 0 1
1 2 2 2 2 1 0 0 0 0 2 2 0 2 1
1 0 0 0 0 1 0 0 3 0 0 0 0 0 1
1 0 0 0 0 1 0 0 0 0 3 0 0 0 1
1 2 2 0 2 2 0 0 0 0 0 0 0 0 1
1 0 0 0 0 0 0 1 2 2 2 2 3 2 1
1 0 4 0 0 0 0 1 3 0 0 0 0 0 1
1 0 7 0 0 0 0 1 0 8 0 0 0 0 1
1 0 0 0 0 0 0 1 0 0 0 0 0 0 1
2 2 2 2 2 2 2 2 2 2 2 2 2 2 2